111111111111111111111111
100000000000000000000001
100000001000000000000001
100010000000000001000001
100000010000000000000001
100000010001000001000001
100000010000000000000001
100010011111100010000001
100000000000000000000001
100000000000000001000001
100000100000001000000001
111111111111111111111111
