111111111111111111111111
100000000000000000000001
10000000D000000000000001
100010000000000001000001
1000000D0000000000000001
10000001000D000001000001
100000010000000000000001
100010011111100010000001
100000000000000000000001
100000000000000001000001
100000100000001000000001
111111111111111111111111
