NO ./textures/east.xpm
 SO ./textures/south.xpm
 WE ./textures/west.xpm
   EA ./textures/north.xpm

F 220,100,0
C 225,30,0
       
        
        1111111111111111111111111
        1000000000110000000000001
        1011000001110000000000001
        1001000000000000000000001
111111111011000001110000000000001
100000000011000001110111111111111
11110111111111011100000010001
11101111 1111011101010010001
1100000D110101011100000010001
1000000000000000D000000000001
10000000000000001101010010001
11000001110101011111011110W0111
11110111 1110101 100011010001
11111111 1111111 111111111111
