NO ./textures/north.xpm
SO ./textures/south.xpm
WE ./textures/west.xpm
EA ./textures/east.xpm
F 0,0,0
C 0,0,0

 11 11
100100111111
 10N00000001
 1001111111
  101
  101
  101
  101
 11011
11000111
10000001
100D1111
11101111
10000001
10000001
11111111
