111111111111111111111111
100000000000000000000001
100000000000000000000001
100000000000000000000001
100000010000000000000001
100000010000000000000001
100000010000000000000001
100000011111100010000001
100000000000000000000001
100000000000000000000001
100000000000001000000001
111111111111111111111111