
NO textures/textures/wall.xpm
SO textures/textures/bricks.xpm
WE textures/textures/gold.xpm
EA textures/textures/wood.xpm
F 220,111,119
C 225,111,0

 11111111111111111111111
1000000000000000000000001
 10000000000000000000001
  100000000000000000001111111111111111111111111111111111111111
   10000000N00000000000000000000000000000000000000000000000001
    1000000000000000111111111111111111111111111111111111111111
     100000000000001
      1000000000001
       10000000001
        100000001
         1000001
          10001
           1D1
			1
